{
	"game":{
        "revive_player_pos":false,
        "revive_times":4,
        "vision":3,
        "power_create_num":10,
		"timeout":8000
	},
	"map":
	{
		"height":20,
		"width":20,
		"map_str":"
			5O5A5555555555555555
5#5555555555555555#5
5<52555######55525>5
v552555555X55555255v
55555555#555#5555555
555555<<55155>>55555
55555555#555#5555555
555555555X555555555O
55<<<a555^5555v555^5
5v555555^5^555v#55^5
55###55#####55v5#5^5
55555v5v252v55v55#^5
55<<<55v555v55v555^5
O55555555X55555555B5
55525555#555#5552555
555255<<55155>>52555
^5525555#555#555255^
5<5####5555555###5>5
5#5555555555555555#5
555555555X555555b5O5

			"
	}
}